###############
#P++++++++++++#
#############+#
#+++++++++++++#
#++++++########
#+++++++++++++#
########++#####
#+++++++++++###
###############