###############
#P+W+++++++++G#
#############+#
#+++++++++++++#
#++++++########
#+++++++++++++#
########++#####
#G+++++++++B###
###############