# # # # # # # # # # # # # # #
# * + + + + + + + + + + + + #
# # # # # # # # # # # # # + #
# + + + + + + + + + + + + + #
# + + + + + + # # # # # # # #
# + + + + + + + + + + + + + #
# # # # # # # # + + # # # # #
# + + + + + + + + + + + # # #
# # # # # # # # # # # # # # #